NO ./textures/wall_n.xpm
SO ./textures/wall_S.xpm
WE ./textures/wall_W.xpm
EA ./textures/wall_e.xpm
F 184,113,39
C 51,198,227

        1111111111111111111111111
        1000000000000000000000001
        1100000000000000000000001
        1000000000000000000000001
111111111000000000000000000000001
100000000000000000000000000001111
10000000000000010000000000001
10000000000000000000000000001
10000000000000000000000000001
10000000000000000000000000001
1000000000000000000101000E001
11000000100101001011011110101
11110111 1110111 101111010001
11111111 1111111 11111111111
