11111111
10000001
10000001
10000001
